NO ./textures/Stone1L.xpm
SO ./textures/Stone1D.xpm
WE ./textures/BrownbrickL.xpm
EA ./textures/BrownbrickD.xpm

F 220,100,0
C 225,300,0

1111111111111111111
1000000000000000001
1000000000000000001
1000000000000000001
1000000000N00000001
1000000000000000001
1000000000000000001
1000000000000000001
1111111111111111111
