NO ./textures/Stone1L.xpm
SO ./textures/BrownbrickL.xpm
WE ./textures/Stone1D.xpm
EA ./textures/BrownbrickD.xpm

F 128,128,120
C 135,206,250

1111111111111111111
1010000000000000001
1110000000000000001
1000000011100000001
1000000010100000001
10000000111000000N1
1111111111111111111
