NO ./textures/Stone1L.xpm
SO ./textures/BrownbrickL.xpm
WE ./textures/Stone1D.xpm
EA ./textures/BrownbrickD.xpm

F 128,128,120
C 135,206,250

1111111111111111111
1000000000000000001
1000000000000000001
1000000000000000001
1000000000N00000001
1000000000000000001
1000001000000000001
1000000000000000001
1111111111111111111
