NO ./textures/Stone1L.xpm
SO ./textures/BrownbrickL.xpm
WE    ./textures/Stone1D.xpm
EA ./textures/BrownbrickD.xpm

C 135   ,  20,  250
F 135,206,250

1111111111111111111
1000000000000000001
1000000000000000001
1000000000000000001
1000000000N00000001
1000000000000000001
1000000000000000001
1000100000000000001
1000000000000000001
1111111111111111111
