NO ./textures/Stone1L.xpm
SO ./textures/Stone1D.xpm
WE ./textures/BrownbrickL.xpm
EA ./textures/BrownbrickD.xpm

F 220,100,0
C 225,300,0

 111111111
1101000001
1010010001
1100N11111
111111
