NO ./textures/Stone1L.xpm
SO ./textures/Stone1D.xpm
WE ./textures/BrownbrickL.xpm
EA ./textures/BrownbrickD.xpm

F 220,100,0
C 225,300,0

  11111111
1110000001
1000010001111111
100N010000000001
1111110001111111
     10001
     10001
     10001
     11111
